29 30 29 67 68 29 30 29 29 29 30 29 29 30 29 29 30 29 
29 29 63 64 65 66 29 30 29 29 29 29 30 29 29 29 29 29 
29 29 57 58 59 60 61 62 27 27 27 27 27 27 27 29 29 29 
29 50 51 52 53 54 55 56 14 18 16 16 16 17 14 29 29 30 
29 43 44 45 46 47 48 49 14 19 21 21 21 20 14 29 29 29 
26 36 37 38 39 40 41 42 14 22 24 24 24 23 14 27 27 27 
26 13 13 13 13 13 13 13 13 15 15 15 15 15 13 13 13 13 
26 13 0 0 0 0 0 13 13 13 13 13 13 13 13 13 13 13 
26 69 7 1 1 1 2 3 31 32 32 32 32 32 32 32 32 32 
26 69 9 70 70 70 4 3 33 35 35 35 35 35 35 35 35 35 
26 69 10 70 70 70 4 3 33 35 35 35 35 35 35 35 35 35 
26 13 70 70 70 70 4 3 33 35 35 35 35 35 35 35 35 35 
26 13 12 12 12 12 5 6 71 34 34 34 34 34 34 34 34 34 
26 13 13 13 13 13 13 13 13 13 13 13 13 13 13 13 13 13 
30 25 25 25 25 25 25 25 25 25 25 25 25 25 25 25 25 25 