0 0 0 0 0 0 0 1 0 1 0 0 0 0 0 0 0 0
0 0 0 0 0 0 0 0 0 1 0 0 0 0 0 0 0 0
0 0 15 13 13 13 17 0 0 1 0 0 0 0 0 0 0 0
0 15 3 3 3 3 3 13 13 17 0 0 0 0 0 0 0 0
0 19 24 23 23 23 23 25 3 3 13 13 13 13 13 13 13 13
0 19 29 15 13 13 17 26 19 3 3 3 3 3 3 3 3 3
0 19 14 3 7 6 20 26 19 3 3 3 3 3 3 3 3 3
0 19 27 19 8 10 20 26 19 3 3 3 3 3 3 3 3 3
0 19 27 16 14 14 18 26 19 3 3 3 3 3 3 3 3 3
0 19 29 22 22 22 22 28 19 3 3 3 3 3 3 3 3 3
0 19 13 13 13 13 13 13 3 3 14 14 14 14 14 14 14 14
0 16 14 14 14 14 14 14 14 18 0 0 0 0 0 0 0 0
0 0 1 1 1 1 1 1 1 1 0 0 0 0 0 0 0 0
0 0 0 0 0 0 0 0 0 0 0 0 0 0 0 0 0 0